<?xml version="1.0" encoding="ISO-8859-1"?>
<!DOCTYPE SokobanLevels SYSTEM "SokobanLev.dtd">
<SokobanLevels>
  <Title>Still More collection</Title>
  <Description>
This collection is copyright J Franklin Mentzer.

  </Description>
  <Email>wryter@aol.com</Email>
  <LevelCollection Copyright="J. Franklin Mentzer" MaxWidth="25" MaxHeight="18">
    <Level Id="#1" Width="12" Height="13">
      <L>   ####</L>
      <L>####  ####</L>
      <L>#    $   ##</L>
      <L>#   #  #  #</L>
      <L>## #.**.#$##</L>
      <L>#   *..*   #</L>
      <L># $ *..*   #</L>
      <L>## #.**.#$##</L>
      <L> #$@#  #  #</L>
      <L> # $ $    #</L>
      <L> #    $  ##</L>
      <L> ##  #####</L>
      <L>  ####</L>
    </Level>
    <Level Id="#2" Width="25" Height="11">
      <L> #######################</L>
      <L>##   #  #  #  #  #  #  ##</L>
      <L>#   $        $          #</L>
      <L>##.# #.###.#.$ #.$$###.##</L>
      <L>#  #.# #.$ # $ #   # #  #</L>
      <L># .###.##  # $ #$$$# #. #</L>
      <L>#  #.# #.$ # $$# @ # #  #</L>
      <L>##.#$#.###.###.###.###.##</L>
      <L>#   $           $  $ $  #</L>
      <L>##  #  #  #  #  #  #   ##</L>
      <L> #######################</L>
    </Level>
    <Level Id="#3" Width="16" Height="16">
      <L>################</L>
      <L>#....#         #</L>
      <L>#....# # ##  # #</L>
      <L>#....  $ #  #  #</L>
      <L>##  #  $   #   #</L>
      <L>#    #$$$$#  # #</L>
      <L># ## $    $ ## #</L>
      <L>#    $ ## $$$  #</L>
      <L># #$$$ ## $  # #</L>
      <L># #  $    $    #</L>
      <L>#   ##$$$$#  ###</L>
      <L>#  #    $  #...#</L>
      <L>#     # $#  ...#</L>
      <L># ## # # #  ...#</L>
      <L>#@         #...#</L>
      <L>################</L>
    </Level>
    <Level Id="#4" Width="21" Height="17">
      <L>#####################</L>
      <L>#.  #.  #.$.#  .#  .#</L>
      <L># #   #   #   #   # #</L>
      <L>#  .#   . $ .   #.  #</L>
      <L># #  .#$$ # $$#.  # #</L>
      <L>#  .#   # $ #   #.  #</L>
      <L># #   #$$ # $$#   # #</L>
      <L>#  .#   # $ #   #.  #</L>
      <L>#@#   #$$$*$$$#   # #</L>
      <L>#  ..   # $ #   ..  #</L>
      <L># #   #$$ # $$#   # #</L>
      <L>#  .#   # $ #   #.  #</L>
      <L># #  .#$$ # $$#.  # #</L>
      <L>#  .#   # $ #   #.  #</L>
      <L># #   #$  #  $#   # #</L>
      <L>#.  #.  #.$.#  .#  .#</L>
      <L>#####################</L>
    </Level>
    <Level Id="#5" Width="15" Height="16">
      <L>###############</L>
      <L>#             #</L>
      <L># $  # $ #    #</L>
      <L># $ # $#$ #   #</L>
      <L># $# $   $    #</L>
      <L>#   $   # $#  #</L>
      <L>#$# $  #  $ #$#</L>
      <L>#  #$ #   $   #</L>
      <L>#    $   $ #$ #</L>
      <L>#   # $#$ # $ #</L>
      <L>#    # $ #  $ #</L>
      <L>#             #</L>
      <L># #####@##### #</L>
      <L>#..... .......#</L>
      <L>#..... .......#</L>
      <L>###############</L>
    </Level>
    <Level Id="#6" Width="16" Height="13">
      <L>##############</L>
      <L>#    ###   #.#</L>
      <L># $     $  #.#</L>
      <L># $  # #   #.##</L>
      <L>## ### ##$##..##</L>
      <L># $  #$#   # @.#</L>
      <L>#  $ $   $  ...#</L>
      <L># $  #$#   #.. #</L>
      <L>## ### ## ##..##</L>
      <L>#  $ # # $ #.##</L>
      <L># $$     $ #.#</L>
      <L>#    ###   #.#</L>
      <L>##############</L>
    </Level>
    <Level Id="#7" Width="13" Height="17">
      <L>     ###</L>
      <L>    ##.##</L>
      <L>    #...#</L>
      <L>  ###..@###</L>
      <L>  #  ...  #</L>
      <L>### ##.## ###</L>
      <L>#     $     #</L>
      <L>#  #  $  #  #</L>
      <L>##$#$###$#$##</L>
      <L>#  #  $  #  #</L>
      <L>#     $     #</L>
      <L>###  # #  ###</L>
      <L>  # ## ## #</L>
      <L>  #  $ $  #</L>
      <L>  # ## ## #</L>
      <L>  #       #</L>
      <L>  #########</L>
    </Level>
    <Level Id="#8" Width="25" Height="13">
      <L>    #####       #####</L>
      <L>  ###   ###   ###   ###</L>
      <L> ##      .## ##   $   ##</L>
      <L> #    # ...# #  $$#  $ #</L>
      <L>## #    .#.###$#  $  # ##</L>
      <L>#    # #  ..#    # # $  #</L>
      <L>#  @   ....*.$ $$$$$$$  #</L>
      <L>#    # #  ..#    # # $  #</L>
      <L>## #    .#.### #     # ##</L>
      <L> #    # ...# #  $ #    #</L>
      <L> ##      .## ## $ $$$ ##</L>
      <L>  ###   ###   ###   ###</L>
      <L>    #####       #####</L>
    </Level>
    <Level Id="#9" Width="14" Height="14">
      <L> ############</L>
      <L>##   #  #   ##</L>
      <L># @ $# $ $ $ #</L>
      <L>#  $    # $  #</L>
      <L># $$ #..#  $ #</L>
      <L>### #....## ##</L>
      <L>#   ..##.. $ #</L>
      <L># $ ..##..   #</L>
      <L>## ##....# ###</L>
      <L># $  #..# $  #</L>
      <L>#  $ #   $ $ #</L>
      <L># $ $ $ # $  #</L>
      <L>##   #  #   ##</L>
      <L> ############</L>
    </Level>
    <Level Id="#10" Width="14" Height="14">
      <L>  ##########</L>
      <L> ##  #  #  ##</L>
      <L>##  $#      ##</L>
      <L>#      $# $  #</L>
      <L># $$ #..# $  #</L>
      <L>### #+*..## ##</L>
      <L>#   .*##..$  #</L>
      <L>#  $..##*.$  #</L>
      <L>## ##..**# ###</L>
      <L># $$ #..#  $ #</L>
      <L>#    #   $   #</L>
      <L>##    $ #$  ##</L>
      <L> ##  #  #  ##</L>
      <L>  ##########</L>
    </Level>
    <Level Id="#11" Width="11" Height="17">
      <L> #########</L>
      <L>##       ##</L>
      <L># $$$ $$$ #</L>
      <L>#      #  #</L>
      <L>#   # $   #</L>
      <L># $#  $ $ #</L>
      <L># $  $# $ #</L>
      <L>## $   $ ##</L>
      <L> ## $ $ ##</L>
      <L>  ## $ ##</L>
      <L>   ##@##</L>
      <L>  ## ..##</L>
      <L>  #. ...#</L>
      <L>  #. ...#</L>
      <L>  #.....#</L>
      <L>  ##...##</L>
      <L>   #####</L>
    </Level>
    <Level Id="#12" Width="12" Height="12">
      <L> ####  ####</L>
      <L> #..####  #</L>
      <L> #.. $    #</L>
      <L>## $ ###  ##</L>
      <L># $#$  .#  #</L>
      <L># $  .# #$ #</L>
      <L># $# #.  $ #</L>
      <L>#  #.  $#$ #</L>
      <L>##  ### $ ##</L>
      <L> #    $@..#</L>
      <L> #  ####..#</L>
      <L> ####  ####</L>
    </Level>
    <Level Id="#13" Width="13" Height="13">
      <L> ###########</L>
      <L>##    #    ##</L>
      <L>#  $$   $$  #</L>
      <L># $#.# #.#$ #</L>
      <L># $...#...$ #</L>
      <L>#  #.$ $.#  #</L>
      <L>##  # $ #  ##</L>
      <L>#  #.$ $.#  #</L>
      <L># $...#...$ #</L>
      <L># $#.# #.#@ #</L>
      <L>#  $$   $$  #</L>
      <L>##    #    ##</L>
      <L> ###########</L>
    </Level>
    <Level Id="#14" Width="13" Height="13">
      <L> ##### #####</L>
      <L>##   ###   ##</L>
      <L>#   $   $   #</L>
      <L>#  #.# #.#  #</L>
      <L># $**.#**.$ #</L>
      <L>## #.$ $.# ##</L>
      <L> #  # $ #  #</L>
      <L>## #.$ $.# ##</L>
      <L># $.*.#.**@ #</L>
      <L>#  #*# #.#  #</L>
      <L>#   $   $   #</L>
      <L>##   ###   ##</L>
      <L> ##### #####</L>
    </Level>
    <Level Id="#15" Width="13" Height="13">
      <L> ##### #####</L>
      <L>##   ###   ##</L>
      <L>#  $   $$ $ #</L>
      <L># $#.# #.#$ #</L>
      <L># $...#...  #</L>
      <L>## #.$$ .# ##</L>
      <L> #$ # $ # $#</L>
      <L>## #. $$.# ##</L>
      <L>#  ...#...$ #</L>
      <L># $#.# #.#@ #</L>
      <L># $ $   $$  #</L>
      <L>##   ###   ##</L>
      <L> ##### #####</L>
    </Level>
    <Level Id="#16" Width="17" Height="18">
      <L>    #########</L>
      <L>    #       #</L>
      <L>   ## $ $ $ ##</L>
      <L>####   $ $$  ####</L>
      <L>#   # $  $  #   #</L>
      <L># $$ # $ $ # $$ #</L>
      <L>#   $ #$ $#  $  #</L>
      <L>#  $   $ $    $ #</L>
      <L># $ $ # $ # $$  #</L>
      <L># $  ### ###  $ #</L>
      <L>#   ## # # ##   #</L>
      <L>#####  #@#  #####</L>
      <L>       # #</L>
      <L>      ## ##</L>
      <L>#######. .#######</L>
      <L>#...... . ......#</L>
      <L>#........ ......#</L>
      <L>#################</L>
    </Level>
    <Level Id="#17" Width="18" Height="15">
      <L>##################</L>
      <L>#..#             #</L>
      <L>#..#  # $ $ $ ## #</L>
      <L>#..# ### # #  #  #</L>
      <L>#..# # $$###$##$ #</L>
      <L>#..#       $@$ $ #</L>
      <L>#..  $# $ # $$ # #</L>
      <L>#  #  #  ###   # #</L>
      <L>#    ###  #  ### #</L>
      <L>#..#    $ $      #</L>
      <L>#..# ##$  #  # $ #</L>
      <L>#..#  #  ### ##  #</L>
      <L>#..#  ##$$ #$##$ #</L>
      <L>#..#             #</L>
      <L>##################</L>
    </Level>
    <Level Id="#18" Width="11" Height="16">
      <L>###########</L>
      <L># .. #    #</L>
      <L># .  #$#$ #</L>
      <L># .  #  $ #</L>
      <L># #  # $$ #</L>
      <L>#    #  $ #</L>
      <L>#.  .#  $ #</L>
      <L>##$## $#  #</L>
      <L>#    @    #</L>
      <L># $#$ ##$##</L>
      <L># $  #..  #</L>
      <L># $  #   .#</L>
      <L># $ $#  #.#</L>
      <L>#  # #  ..#</L>
      <L>#    #....#</L>
      <L>###########</L>
    </Level>
    <Level Id="#19" Width="15" Height="14">
      <L>      ###</L>
      <L>    ### ###</L>
      <L>  ###. ...###</L>
      <L>  # $.$.$.$ #</L>
      <L> ## ###.### ##</L>
      <L> #  #...$.#  #</L>
      <L> #  $.....$  #</L>
      <L>##  #... .#  ##</L>
      <L># #$ ##.## $# #</L>
      <L>#  $  $     $ #</L>
      <L># $#$ $$$ $#$@#</L>
      <L>#       $$  $ #</L>
      <L>###   ###   ###</L>
      <L>  ##### #####</L>
    </Level>
    <Level Id="#20" Width="11" Height="16">
      <L>###########</L>
      <L>#     #   #</L>
      <L>#   $  $  #</L>
      <L>##### #   #</L>
      <L>##### ###.#</L>
      <L>#  #    #.#</L>
      <L># $   $ #.#</L>
      <L>#  ### ##.#</L>
      <L>## ###  #.#</L>
      <L># $   $ #.#</L>
      <L>#   ##  #.#</L>
      <L>### #####.#</L>
      <L>### #   @ #</L>
      <L>#  $    $ #</L>
      <L>#    ##   #</L>
      <L>###########</L>
    </Level>
    <Level Id="#21" Width="13" Height="15">
      <L>    #####</L>
      <L>  ### . ###</L>
      <L> ##  ...  ##</L>
      <L>## $#...#$ ##</L>
      <L>#    #$#    #</L>
      <L>#     $     #</L>
      <L># #$##$##$# #</L>
      <L>#   $.@.$   #</L>
      <L># #$##$##$# #</L>
      <L>#     $     #</L>
      <L>##   #$#   ##</L>
      <L> ##$#...#$##</L>
      <L>  #  ...  #</L>
      <L>  ### . ###</L>
      <L>    #####</L>
    </Level>
    <Level Id="#22" Width="10" Height="15">
      <L> ########</L>
      <L>##.     ##</L>
      <L>#.. $$$  #</L>
      <L>#..# $ # #</L>
      <L>#  #   # #</L>
      <L>#  # $$# #</L>
      <L>#..#$  # #</L>
      <L>#..$ # $@#</L>
      <L>#..#   # #</L>
      <L>#  # $ # #</L>
      <L>#  #$  # #</L>
      <L>#..#  $# #</L>
      <L>#.. $$$  #</L>
      <L>##.   $ ##</L>
      <L> ########</L>
    </Level>
    <Level Id="#23" Width="17" Height="15">
      <L> ###############</L>
      <L> #      #      #</L>
      <L> # #$$   $ $ # #</L>
      <L> #   $ # #$  $ #</L>
      <L> # #$ $  $ $ # #</L>
      <L> # #  $ #$   # #</L>
      <L>## # ##   ## # ##</L>
      <L># $ #  # #  # $ #</L>
      <L>#       #       #</L>
      <L>##  # # # # #  ##</L>
      <L> ##    ...    ##</L>
      <L>  # # #.@.# # #</L>
      <L>  #  .......  #</L>
      <L>  #####...#####</L>
      <L>      #####</L>
    </Level>
    <Level Id="#24" Width="18" Height="12">
      <L>       #####  ####</L>
      <L>       #   ####  #</L>
      <L> ####### #   $ $ #</L>
      <L> #   ##  $ ## #  #</L>
      <L> # $   ..#.## $ ##</L>
      <L> # $ ##.... $ # #</L>
      <L> # #  $....## $ #</L>
      <L>##$$ ##.#..   $ #</L>
      <L>#  # ## $  ## @ #</L>
      <L>#     $ # #######</L>
      <L>#  ####   #</L>
      <L>####  #####</L>
    </Level>
    <Level Id="#25" Width="15" Height="15">
      <L>###############</L>
      <L>#   #####     #</L>
      <L>#    . .      #</L>
      <L>#.#.## ##.### #</L>
      <L>#...  $  .... #</L>
      <L>##.. # # ..## #</L>
      <L>###### ###### #</L>
      <L>#    # #    # #</L>
      <L># $$ #$# $$ # #</L>
      <L># $ $ $ $ $ # #</L>
      <L># $$ #$# $$ # #</L>
      <L>#    #@#    # #</L>
      <L># #### ### ## #</L>
      <L>#             #</L>
      <L>###############</L>
    </Level>
    <Level Id="#26" Width="15" Height="16">
      <L> ##############</L>
      <L> #     #      #</L>
      <L>## ##    # ## #</L>
      <L>#..... .....# #</L>
      <L>#.. .# #. ..# #</L>
      <L>###### ###### #</L>
      <L>     #        #</L>
      <L> ##### $##### #</L>
      <L> #    #@#   # #</L>
      <L>##$ $ #$#   # #</L>
      <L># $  $ $  $$$ #</L>
      <L>#  $  #$#   # #</L>
      <L>#   $$# #$$ # #</L>
      <L>####      ### #</L>
      <L>   ######     #</L>
      <L>        #######</L>
    </Level>
    <Level Id="#27" Width="15" Height="14">
      <L>###############</L>
      <L>#      #......#</L>
      <L># $$ # $.#....#</L>
      <L>#   # $#@ #...#</L>
      <L># $# $ # $ #..#</L>
      <L>#   $  #$$  ..#</L>
      <L># $ #$ #  #.$.#</L>
      <L>#  #  $ $  #..#</L>
      <L># # $  #    # #</L>
      <L>#    # #$#  $$#</L>
      <L>#   # $#  #   #</L>
      <L>#  #   $$  #  #</L>
      <L>#      #      #</L>
      <L>###############</L>
    </Level>
    <Level Id="#28" Width="17" Height="15">
      <L>#################</L>
      <L>#       #.......#</L>
      <L># $$$ # $.#.....#</L>
      <L>#  # $ ......#..#</L>
      <L># $  # ###.#..  #</L>
      <L>#  $ $$ #       #</L>
      <L>#  # $   $$  #  #</L>
      <L># ##  # # #  ## #</L>
      <L># $ $## # ##    #</L>
      <L># $@$ $ #       #</L>
      <L># $ $   #       #</L>
      <L>#  ##$$ #  ##   #</L>
      <L># $$  $ #       #</L>
      <L>#               #</L>
      <L>#################</L>
    </Level>
    <Level Id="#29" Width="17" Height="17">
      <L>#################</L>
      <L>#...           .#</L>
      <L># $#$  # # # $  #</L>
      <L>#.  $ # # # # $.#</L>
      <L>## $ #       #  #</L>
      <L>#   #  #####  # #</L>
      <L>#  #  #     # # #</L>
      <L># #  #  ### # # #</L>
      <L># .$ . #        #</L>
      <L># #$ # #  # # # #</L>
      <L># #  #  #$# # # #</L>
      <L># .#  #   # # #@#</L>
      <L>#   #  ### $# # #</L>
      <L># $$ #     $..#$#</L>
      <L>##.   ######$##.#</L>
      <L> ##.$      .   .#</L>
      <L>  ###############</L>
    </Level>
    <Level Id="#30" Width="14" Height="17">
      <L>      #####</L>
      <L>#######   ####</L>
      <L>#.*.  $$  $  #</L>
      <L>#.. ### ## # #</L>
      <L>#...# #  # # #</L>
      <L>## #  #  # # #</L>
      <L>##$$  #$ # # #</L>
      <L>#  #.$   # $ #</L>
      <L># . #$$$   #@#</L>
      <L>#  #.$   # # #</L>
      <L>##$$  #$ # # #</L>
      <L> # #  #  # # #</L>
      <L>## ###  ## # #</L>
      <L>#...  $$  $  #</L>
      <L>#.. ###   ####</L>
      <L>#...# #####</L>
      <L>#####</L>
    </Level>
    <Level Id="#31" Width="15" Height="13">
      <L>###############</L>
      <L>#     #   #   #</L>
      <L># $$  $   $ $ #</L>
      <L>#  $ ###### # #</L>
      <L># $$ #@  #  $ #</L>
      <L>#    #  $    ##</L>
      <L>######$##  ##.#</L>
      <L> #   # $   #..#</L>
      <L> #    $   #...#</L>
      <L> ## #### # ...#</L>
      <L> #  $   $*....#</L>
      <L> #   #   #.  .#</L>
      <L> ##############</L>
    </Level>
    <Level Id="#32" Width="15" Height="16">
      <L>#############</L>
      <L>#....#  ##  #</L>
      <L>#.. .# $ $$ #</L>
      <L>#.....@ ##  #</L>
      <L>#....## #  ##</L>
      <L>##.####$#  #</L>
      <L>#  #       #</L>
      <L># $  $ ###$####</L>
      <L>## ###    $   #</L>
      <L># $ # $# ## $ #</L>
      <L>#    $  $ ## ##</L>
      <L>#######  $## ##</L>
      <L>    ###$ $    #</L>
      <L>    #    $#   #</L>
      <L>    #     #####</L>
      <L>    #######</L>
    </Level>
    <Level Id="#33" Width="15" Height="14">
      <L> #####  ####</L>
      <L> #.  ####  #</L>
      <L> #.#   $   #</L>
      <L> #.### # # ##</L>
      <L> #   $ $ $  #</L>
      <L>## ### # ## ##</L>
      <L>#. ..#$@$$   #</L>
      <L>#..# # $ #   #</L>
      <L>#.##  # #  # ##</L>
      <L># $      $#.. #</L>
      <L># $#$#$# $ ...#</L>
      <L>## #      #####</L>
      <L> #     ####</L>
      <L> #######</L>
    </Level>
    <Level Id="#34" Width="18" Height="17">
      <L>##################</L>
      <L>#   #        #   #</L>
      <L># $$#$ $ # # # $ #</L>
      <L>#  $     # #$# $ #</L>
      <L># $ ##$## $  $  ##</L>
      <L># # $ $  # # #   #</L>
      <L>#  $#   $# # # $ #</L>
      <L>### #     $ $#   #</L>
      <L># $ #  #$# #  ####</L>
      <L># #  ###  #  #   #</L>
      <L>#  ..#.   #    $ #</L>
      <L>###..#.#  #  # $ #</L>
      <L>#...##.# # #$## ##</L>
      <L>#. . ...#      $ #</L>
      <L>#. .....# $ ## $ #</L>
      <L>#...#...#   @#   #</L>
      <L>##################</L>
    </Level>
    <Level Id="#35" Width="13" Height="13">
      <L>#############</L>
      <L>#  . . . .  #</L>
      <L># # # # # # #</L>
      <L># # # # # # #</L>
      <L>#.$ # $ # $.#</L>
      <L># # # # # # #</L>
      <L># #$$$#$$$# #</L>
      <L># # # # # # #</L>
      <L>#.$ # $ # $ #</L>
      <L># # # # # #.#</L>
      <L># # # # # # #</L>
      <L>#  . .@. .  #</L>
      <L>#############</L>
    </Level>
  </LevelCollection>
</SokobanLevels>
